1,1,1,1,1,1,1,1,1,1,1,1,1,1,1,1,1,1,1,1,1;
1,1,4,4,4,4,4,4,4,4,1,4,4,4,4,4,4,4,4,1,1;
1,1,5,1,1,4,1,1,1,4,1,4,1,1,1,4,1,1,5,1,1;
1,1,4,4,4,4,4,4,4,4,4,4,4,4,4,4,4,4,4,1,1;
1,1,4,1,1,4,1,4,1,1,1,1,1,4,1,4,1,1,4,1,1;
1,1,4,4,4,4,1,4,4,4,1,4,4,4,1,4,4,4,4,1,1;
1,1,1,1,1,4,1,1,1,4,1,4,1,1,1,4,1,1,1,1,1;
1,1,1,1,1,4,1,4,4,4,4,4,4,4,1,4,1,1,1,1,1;
1,1,1,1,1,4,1,4,1,1,2,1,1,4,1,4,1,1,1,1,1;
1,1,1,4,4,4,4,4,1,2,2,2,1,4,4,4,4,4,1,1,1;
1,1,1,1,1,4,1,4,1,1,6,1,1,4,1,4,1,1,1,1,1;
1,1,1,1,1,4,1,4,1,1,1,1,1,4,1,4,1,1,1,1,1;
1,1,1,1,1,4,1,4,4,4,4,4,4,4,1,4,1,1,1,1,1;
1,1,1,1,1,4,1,4,1,1,1,1,1,4,1,4,1,1,1,1,1;
1,1,4,4,4,4,4,4,4,4,1,4,4,4,4,4,4,4,4,1,1;
1,1,4,1,1,4,1,1,1,4,1,4,1,1,1,4,1,1,4,1,1;
1,1,4,4,1,4,4,4,4,4,3,4,4,4,4,4,1,4,4,1,1;
1,1,1,4,1,4,1,4,1,1,1,1,1,4,1,4,1,4,1,1,1;
1,1,4,4,4,4,1,4,4,4,1,4,4,4,1,4,4,4,4,1,1;
1,1,5,1,1,1,1,1,1,4,1,4,1,1,1,1,1,1,5,1,1;
1,1,4,4,4,4,4,4,4,4,4,4,4,4,4,4,4,4,4,1,1;
1,1,1,1,1,1,1,1,1,1,1,1,1,1,1,1,1,1,1,1,1